Багдановіч Максім = Багдановіч
Багушэвіч Францішак = Багушэвіч
Бядуля Змітрок = Бядуля
Галубок Уладзіслаў = Галубок
Гартны Цішка = Гартны
Гарэцкі Максім = Гарэцкі
Караткевіч Уладзімір = Караткевіч
Колас Якуб = Колас
Крапіва Кандрат = Крапіва
Купала Янка = Купала
Лучына Янка = Лучына
Танк Максім = Танк
Цётка = Цётка
Чорны Кузьма = Чорны
Ядвігін Ш. = Ядвігін Ш.

Барадулін Рыгор = Барадулін
Брыль Янка = Брыль
Бураўкін Генадзь = Бураўкін
Быкаў Васіль = Быкаў
Геніюш Ларыса = Геніюш
Гілевіч Ніл = Гілевіч
Мележ Іван = Мележ
Навуменка Іван = Навуменка
Пташнікаў Іван = Пташнікаў
Чыгрынаў Іван = Чыгрынаў
Шамякін Іван = Шамякін

Броўка Пятрусь = Броўка
Гарун Алесь = Гарун
Глебка Пятро = Глебка
Дубоўка Уладзімір = Дубоўка
Жылка Уладзімір = Жылка
Калюга Лукаш = Калюга
Куляшоў Аркадзь = Куляшоў
Лужанін Максім = Лужанін
Лынькоў Міхась = Лынькоў
Мрый Андрэй = Мрый
Чарот Міхась = Чарот

Адамчык Вячаслаў = Адамчык
Макаёнак Андрэй = Макаёнак
Някляеў Уладзімір = Някляеў
Панчанка Пімен = Панчанка
Паўловіч Альберт = Паўловіч
Разанаў Алесь = Разанаў
Стральцоў Міхась = Стральцоў
Сыс Анатоль = Сыс

Бабарэка Адам = Бабарэка
Баравікова Раіса = Баравікова
Васілевіч Алена = Васілевіч
Вераніцын Кастусь = Вераніцын
Гурыновіч Адам = Гурыновіч
Дайнека Леанід = Дайнека
Дунін-Марцінкевіч Вінцэнт = Дунін-Марцінкевіч
Каганец Карусь = Каганец
Каліноўскі Кастусь = Каліноўскі
Каратынскі Вінцэсь = Каратынскі
Пушча Язэп = Пушча
Русак Адам = Русак
Скрыган Ян = Скрыган
Федарэнка Андрэй = Федарэнка

Александровіч Андрэй = Александровіч
Аляхновіч Францішак = Аляхновіч
Вярцінскі Анатоль = Вярцінскі
Дудар Алесь = Дудар
Канчэўскі Ігнат = Канчэўскі
Карпюк Аляксей = Карпюк
Ластоўскі Вацлаў = Ластоўскі
Леўчык Гальяш = Леўчык
Лёсік Язэп = Лёсік
Сіпакоў Янка = Сіпакоў
Тарашкевіч Браніслаў = Тарашкевіч
Янішчыц Яўгенія = Янішчыц

Адамовіч Алесь = Адамовіч Алесь
Адамовіч Антон = Адамовіч Антось
Адважны Вінцук = Адважны
Акула Кастусь = Акула
Баранавых Сымон = Баранавых
Грамыка Міхайла = Грамыка
Кіпель Вітаўт = Кіпель
Машара Міхась = Машара
Пазняк Зянон = Пазняк
Родзевіч Леапольд = Родзевіч
Савёнак Лявон = Савёнак
Сачанка Барыс = Сачанка
Сяднёў Масей = Сяднёў
Яновіч Сакрат = Яновіч

Васючэнка Пятро = Васючэнка
Калеснік Уладзімір = Калеснік
Клышка Алесь = Клышка
Лойка Алег = Лойка
Ліс Арсень = Ліс
Мальдзіс Адам = Мальдзіс
Надсан Аляксандр = Надсан
Прыгодзіч Зіновій = Прыгодзіч
Скобла Міхась = Скобла
Сёмуха Васіль = Сёмуха
Цвірка Кастусь = Цвірка

Вялюгін Анатоль = Вялюгін
Грачанікаў Анатоль = Грачанікаў
Гурскі Ілья = Гурскі
Жук Алесь = Жук
Зарыцкі Алесь = Зарыцкі Алесь
Зарыцкі Аляксей = Зарыцкі Аляксей
Масарэнка Алесь = Масарэнка
Пальчэўскі Алесь = Пальчэўскі
Петрашкевіч Алесь = Петрашкевіч
Пысін Аляксей = Пысін
Пісьмянкоў Алесь = Пісьмянкоў
Сяркоў Іван = Сяркоў
Якімовіч Алесь = Якімовіч

Астапенка Алесь = Астапенка Алесь
Асіпенка Алесь = Асіпенка
Гардзей Віктар = Гардзей
Звонак Алесь = Звонак
Зуёнак Васіль = Зуёнак
Зэкаў Анатоль = Зэкаў
Казека Алесь = Казека
Казько Віктар = Казько
Кудравец Анатоль = Кудравец
Сабалеўскі Анатоль = Сабалеўскі
Сербантовіч Анатоль = Сербантовіч
Чарнышэвіч Аркадзь = Чарнышэвіч

Далідовіч Генрых = Далідовіч
Законнікаў Сяргей = Законнікаў
Карамазаў Віктар = Карамазаў
Кірэенка Кастусь = Кірэенка
Лупсякоў Мікола = Лупсякоў
Міско Якуб = Міско
Панізнік Сяргей = Панізнік
Пархута Яраслаў = Пархута
Праўдзін Віктар = Праўдзін
Сабаленка Раман = Сабаленка
Самуйлёнак Эдуард = Самуйлёнак
Чыгрын Сяргей = Чыгрын

Галавач Платон = Галавач
Глыбінны Уладзімір = Глыбінны
Гурло Алесь = Гурло
Дудзіцкі Уладзімір = Дудзіцкі
Засім Мікола = Засім
Крушына Рыгор = Крушына
Моркаўка Аркадзь = Моркаўка
Мікуліч Барыс = Мікуліч
Пестрак Піліп = Пестрак
Салавей Алесь = Салавей
Трус Паўлюк = Трус
Шынклер Хвядос = Шынклер

Бадак Алесь = Бадак
Бачыла Алесь = Бачыла
Бічэль-Загнетава Данута = Бічэль-Загнетава
Дзітрых Алесь = Дзітрых
Дранько-Майсюк Леанід = Дранько-Майсюк
Жанчак Барыс = Жанчак
Жуковіч Васіль = Жуковіч
Кірылаў Герман = Кірылаў
Ліпскі Уладзімір = Ліпскі
Марціновіч Аркадзь = Марціновіч
Масла Алена = Масла
Мацяш Ніна = Мацяш

Асташонак Алесь = Асташонак
Бажко Алесь = Бажко
Вольскі Артур = Вольскі
Вярба Вера = Вярба
Вітка Васіль = Вітка
Гадулька Васіль = Гадулька
Гігевіч Васіль = Гігевіч
Дубатоўка Валянцін = Дубатоўка
Лукша Валянцін = Лукша
Рагаўцоў Васіль = Рагаўцоў
Хомчанка Васіль = Хомчанка
Якавенка Васіль = Якавенка

Агняцвет Эдзі = Агняцвет
Арабей Лідзія = Арабей
Арочка Мікола = Арочка
Аўрамчык Мікола = Аўрамчык
Ваданосаў Мікола = Ваданосаў
Гіль Мікола = Гіль
Дубінка Вячаслаў = Дубінка
Лобан Мікола = Лобан
Лось Еўдакія = Лось
Маляўка Мікола = Маляўка
Мятліцкі Мікола = Мятліцкі
Хромчанка Кузьма = Хромчанка

Бондар Таіса = Бондар
Бітэль Пятро = Бітэль
Дамашэвіч Уладзімір = Дамашэвіч
Калачынскі Міхась = Калачынскі
Карпаў Уладзімір = Карпаў
Карызна Уладзімір = Карызна
Клішэвіч Уладзімір = Клішэвіч
Ліхтаровіч Георгій = Ліхтаровіч
Марчук Георгій = Марчук
Місько Павел = Місько

Астапенка Змітрок = Астапенка Змітрок
Буйло Канстанцыя = Буйло
Верас Зоська = Верас
Вечар Алесь = Вечар
Гародня Алесь = Гародня
Гмырак Лявон = Гмырак
Іверс Анатоль = Іверс
Краўцоў Макар = Краўцоў
Лейка Кандрат = Лейка
Міровіч Еўсцігней = Міровіч
Сваяк Казімір = Сваяк
Ставер Алесь = Ставер
Улас Стары = Улас
Хадыка Уладзімір = Хадыка

Акудовіч Валянцін = Акудовіч
Аркуш Алесь = Аркуш
Барскі Алесь = Барскі
Бахарэвіч Альгерд = Бахарэвіч
Гапееў Валерый = Гапееў
Глобус Адам = Глобус
Жыбуль Віктар = Жыбуль
Мінкін Алег = Мінкін
Мірончык Уладзімір = Мірончык
Наварыч Алесь = Наварыч
Хадановіч Андрэй = Хадановіч

Абламейка Сяргей = Абламейка
Адамовіч Славамір = Адамовіч
Давідовіч Сяргей = Давідовіч
Дубавец Сяргей = Дубавец
Дудзюк Зінаіда = Дудзюк
Мудроў Вінцэсь = Мудроў
Рублеўская Людміла = Рублеўская
Севярынец Павел = Севярынец
Сом Лера = Сом
Сільнова Людка = Сільнова
Харэўскі Сяргей = Харэўскі

Акулін Эдуард = Акулін
Арлоў Уладзімір = Арлоў
Барысік Таццяна = Барысік
Віцьбіч Юрка = Віцьбіч
Гніламёдаў Уладзімір = Гніламёдаў
Запруднік Янка = Запруднік
Содаль Уладзімір = Содаль
Сокалаў-Воюш Сяржук = Сокалаў-Воюш
Сцяпан Уладзімір = Сцяпан
Федасеенка Уладзімір = Федасеенка
Юхнавец Янка = Юхнавец
Ялугін Эрнэст = Ялугін
